{
  "maps": [
    {
      "id": "village",
      "name": "Village Square",
      "width": 20,
      "height": 15,
      "layers": {
        "ground": [
          [0,0,0,0,0,0,0,0,0,0,0,0,0,0,0,0,0,0,0,0],
          [0,0,0,0,0,0,0,0,0,0,0,0,0,0,0,0,0,0,0,0],
          [0,0,2,2,2,2,2,0,0,0,0,0,0,2,2,2,2,2,0,0],
          [0,0,2,4,4,4,2,0,0,0,0,0,0,2,4,4,4,2,0,0],
          [0,0,2,4,4,4,2,0,0,0,0,0,0,2,4,4,4,5,0,0],
          [0,0,2,4,4,4,5,0,0,1,1,0,0,2,2,2,2,2,0,0],
          [0,0,2,2,2,2,2,0,0,1,1,0,0,0,0,0,0,0,0,0],
          [0,0,0,0,0,0,0,0,1,1,1,1,0,0,0,0,0,0,0,0],
          [1,1,1,1,1,1,1,1,1,1,1,1,1,1,1,1,1,1,1,1],
          [0,0,0,0,0,0,0,0,1,1,1,1,0,0,0,0,0,0,0,0],
          [0,0,0,3,3,3,0,0,0,1,1,0,0,0,0,0,0,0,0,0],
          [0,0,3,3,3,3,3,0,0,1,1,0,0,0,0,0,0,0,0,0],
          [0,0,3,3,3,3,3,0,0,0,0,0,0,0,0,0,0,0,0,0],
          [0,0,0,3,3,3,0,0,0,0,0,0,0,0,0,0,0,0,0,0],
          [0,0,0,0,0,0,0,0,0,0,0,0,0,0,0,0,0,0,0,0]
        ],
        "collision": [
          [0,0,0,0,0,0,0,0,0,0,0,0,0,0,0,0,0,0,0,0],
          [0,0,0,0,0,0,0,0,0,0,0,0,0,0,0,0,0,0,0,0],
          [0,0,1,1,1,1,1,0,0,0,0,0,0,1,1,1,1,1,0,0],
          [0,0,1,0,0,0,1,0,0,0,0,0,0,1,0,0,0,1,0,0],
          [0,0,1,0,0,0,1,0,0,0,0,0,0,1,0,0,0,0,0,0],
          [0,0,1,0,0,0,0,0,0,0,0,0,0,1,1,1,1,1,0,0],
          [0,0,1,1,1,1,1,0,0,0,0,0,0,0,0,0,0,0,0,0],
          [0,0,0,0,0,0,0,0,0,0,0,0,0,0,0,0,0,0,0,0],
          [0,0,0,0,0,0,0,0,0,0,0,0,0,0,0,0,0,0,0,0],
          [0,0,0,0,0,0,0,0,0,0,0,0,0,0,0,0,0,0,0,0],
          [0,0,0,1,1,1,0,0,0,0,0,0,0,0,0,0,0,0,0,0],
          [0,0,1,1,1,1,1,0,0,0,0,0,0,0,0,0,0,0,0,0],
          [0,0,1,1,1,1,1,0,0,0,0,0,0,0,0,0,0,0,0,0],
          [0,0,0,1,1,1,0,0,0,0,0,0,0,0,0,0,0,0,0,0],
          [0,0,0,0,0,0,0,0,0,0,0,0,0,0,0,0,0,0,0,0]
        ]
      },
      "playerSpawn": { "x": 9, "y": 9 }
    },
    {
      "id": "classroom",
      "name": "Classroom",
      "width": 12,
      "height": 10,
      "layers": {
        "ground": [
          [2,2,2,2,2,2,2,2,2,2,2,2],
          [2,4,4,4,4,4,4,4,4,4,4,2],
          [2,4,4,4,4,4,4,4,4,4,4,2],
          [2,4,4,4,4,4,4,4,4,4,4,2],
          [2,4,4,4,4,4,4,4,4,4,4,2],
          [2,4,4,4,4,4,4,4,4,4,4,2],
          [2,4,4,4,4,4,4,4,4,4,4,2],
          [2,4,4,4,4,4,4,4,4,4,4,2],
          [2,4,4,4,4,4,4,4,4,4,4,2],
          [2,2,2,2,2,5,5,2,2,2,2,2]
        ],
        "collision": [
          [1,1,1,1,1,1,1,1,1,1,1,1],
          [1,0,0,0,0,0,0,0,0,0,0,1],
          [1,0,0,0,0,0,0,0,0,0,0,1],
          [1,0,0,0,0,0,0,0,0,0,0,1],
          [1,0,0,0,0,0,0,0,0,0,0,1],
          [1,0,0,0,0,0,0,0,0,0,0,1],
          [1,0,0,0,0,0,0,0,0,0,0,1],
          [1,0,0,0,0,0,0,0,0,0,0,1],
          [1,0,0,0,0,0,0,0,0,0,0,1],
          [1,1,1,1,1,0,0,1,1,1,1,1]
        ]
      },
      "playerSpawn": { "x": 5, "y": 8 }
    }
  ]
}
